#########
#   ## ##
#      ##
#    ####
##     ##
#   #  ##
#   #  ##
#       #
#########