##########
#        #
#        #
#        #
#        #
####?### #
#    #   #
#  #     #
##########